"1111111111111111",
"1000000110000001",
"1011110000111101",
"1011110110111101",
"1000000110000001",
"1011110110111101",
"1010000000000101",
"1010101111010101",
"1010101111010101",
"1010100000010101",
"1010101111010101",
"1000000000000001",
"1011101100011101",
"1000101001010001",
"1010100011010101",
"1000000000000001",
"1111111111111111"
