unsigned char MAP[17][17] ={
	"1111111111111111",
	"1200002112000021",
	"1011112002111101",
	"1011110110111101",
	"1200002112000021",
	"1011110110111101",
	"1010002002002101",
	"1010103553010101",
	"1010103333010101",
	"1010100000010101",
	"1010101111010101",
	"1202020020202021",
	"1011101100011101",
	"1202101201012021",
	"1010100011010101",
	"1202020200002021",
	"1111111111111111"
};
